111111111111111111111111111111111111111111111
110000010000000000000000000000000000000000001
100000P10000000000000000000000000001111000011
100000010000000000000000000000000000001000011
100001110000001110000001110000000000001111011
1000000000000000000000001C0000000000001000011
100000000000000000000000111111111111111001011
1000000000000000000000001C0000000000000001011
101111110000000011111111111110000001111001011
10000C10000000000000000000E0000000000010C1011
111111111111111111111111111111111111111111111